###############
#             #
#             #
#             #
#             #
#             #
#             #
#      s      #
#             #
#             #
#             #
#             #
#             #
#             #
###############